{
  "明": ["日", "月"],
  "林": ["木", "木"],
  "森": ["木", "林"],
  "岩": ["山", "石"],
  "男": ["田", "力"],
  "空": ["ウ", "工"],
  "晴": ["日", "青"],
  "青": ["主", "月"],
  "雲": ["雨", "云"],
  "雪": ["雨", "ヨ"],
  "雷": ["雨", "田"],
  "電": ["雨", "申"],
  "鳴": ["口", "鳥"],
  "語": ["言", "吾"],
  "話": ["言", "舌"],
  "読": ["言", "売"],
  "休": ["イ", "木"],
  "体": ["イ", "本"],
  "信": ["イ", "言"],
  "付": ["イ", "寸"],
  "村": ["木", "寸"],
  "町": ["田", "丁"],
  "思": ["田", "心"],
  "間": ["門", "日"],
  "聞": ["門", "耳"],
  "問": ["門", "口"],
  "開": ["門", "幵"],
  "閉": ["門", "オ"],
  "回": ["囗", "口"],
  "国": ["囗", "玉"],
  "園": ["囗", "袁"],
  "図": ["囗", "乂"],
  "時": ["日", "寺"],
  "詩": ["言", "寺"],
  "持": ["扌", "寺"],
  "待": ["彳", "寺"],
  "特": ["牛", "寺"],
  "池": ["氵", "也"],
  "地": ["土", "也"],
  "他": ["イ", "也"],
  "海": ["氵", "毎"],
  "洋": ["氵", "羊"],
  "活": ["氵", "舌"],
  "法": ["氵", "去"],
  "花": ["艹", "化"],
  "草": ["艹", "早"],
  "茶": ["艹", "余"],
  "親": ["亲", "見"],
  "亲": ["立", "木"],
  "見": ["目", "儿"],
  "貝": ["目", "八"],
  "買": ["罒", "貝"],
  "売": ["士", "儿"],
  "教": ["孝", "攵"],
  "数": ["娄", "攵"],
  "新": ["亲", "斤"],
  "暗": ["日", "音"],
  "音": ["立", "日"],
  "早": ["日", "十"],
  "星": ["日", "生"],
  "春": ["三", "人", "日"],
  "鉄": ["金", "失"],
  "銀": ["金", "艮"],
  "銅": ["金", "同"],
  "鏡": ["金", "竟"],
  "駅": ["馬", "尺"],
  "験": ["馬", "僉"],
  "飯": ["食", "反"],
  "飲": ["食", "欠"],
  "飼": ["食", "司"],
  "鯨": ["魚", "京"],
  "鮮": ["魚", "羊"],
  "鮫": ["魚", "交"]
}